NO textures/wood0.xpm
SO textures/wood1.xpm
WE textures/wood2.xpm
EA textures/wood3.xpm

F 81,41,28
C 53,168,230

1111111111111111111111111111
1000000000000000000000000001
1000000000110000010000000001
1000000000000000000000000001
1000000000000000000000000001
1000000000000000000000000001
1000000000000000000000000001
1000000000000000000000000001
1000000000000000000000000001
1000000000000000000000000001
100000000000N000000000000001
1000000000000000000000000001
1111111111111111111111111111
