NO textures/lbenj1.xpm
SO textures/lbenj2.xpm
WE textures/lbenj3.xpm
EA textures/lbenj4.xpm
F 81,41,28
C 53,168,230

1111111111111111111111111111
1000000000000000000000000001
1000000000000000000000000001
1001000000000001100000000001
1000000000000000000000000001
1000000000000000000000000001
10000000000000N0000000000001
1000000000000000000000000001
1000000000000000000000000001
1000000001111111000000000001
1000000000000000000000000001
1000000000000000000000000001
1111111111111111111111111111
